
      
     S textures/tasse.xpm
      

    R   1440 900

     NO textures/dbarbie.xpm
           SO textures/dreine.xpm

 WE  textures/dfleur.xpm

EA                 textures/dpatrice.xpm



C     245,140,160 

        F         200,100,132



111111111111
100000000001111111111111
1000000020002000E00000001
100000000002000111110211
100000200000000111110011
100000000000000111110011
11111100000002000000001
100000000111000000001111
100020000000000000000001
100000000111001111111111
10000020011100000000001
10000000000000000000111111
100002000000000000000001
10000000000000000000001
100000200020000000000001
111111111111000000011111
         111000000011111
         111000000011111
          111111111111